Welcome to Virtual Labs - A MHRD Govt of india Initiative	एमएचआरडी,भारत सरकार के एक उपक्रम-वर्चुअल लैब्स में आपका स्वागत है 
Toggle navigation	टॉगल से मार्गनिर्देशन करना 
HOME	गृह 
ALL LABS	सभी प्रयोगशालाएँ 
PARTNERS	साझीदार 
CONTACT	संपर्क 
Chemical Sciences	रसायन विज्ञान 
Introduction Experiments Target Audience Courses Aligned Pre-requisite Softwares Feedback	परिचय, प्रयोग, लक्ष्य, श्रोतागण पाठ्यक्रम,संरेखित पूर्व-अपेक्षित सॉफ्टवेयर्स, प्रतिक्रिया 
Physical Chemistry Lab	भौतिकी रसायन विज्ञान प्रयोगशाला (कार्यशाला)
Chemical sciences curriculum covered by the lab:	कार्यशाला में पूर्ण किया गया रसायन विज्ञान पाठ्यक्रम:
Majority of the Spectroscopy and Analytical techniques that are studied at the undergraduate and post graduate chemical sciences courses have been covered. Electron Paramagnetic Resonance Spectroscopy (EPR), Nuclear Magnetic Resonance Spectroscopy (NMR). Infra Red Spectroscopy (IR), Electron Ionisation or Impact mass spectroscopy (EI-MS) and Cyclic Voltammetry (CV)	पूर्व-स्नातक और स्नातकोत्तर स्तर पर पढ़ाए जाने वाले रसायन विज्ञान पाठ्यक्रम में, स्पेक्ट्रोस्कोपी और विश्लेषण की अधिकांशतः तकनीकों को पूर्ण कर लिया गया है। इलेक्ट्रॉन परा-चुम्बकीय अनुकम्पन स्पेक्ट्रोस्कोपी (ईपीआर), नाभिकीय चुंबकीय अनुकम्पन स्पेक्ट्रोस्कोपी (एनएमआर)। इन्फ्रा रेड स्पेक्ट्रोस्कोपी (आईआर), इलेक्ट्रॉन आयनीकरण या इम्पैक्ट मास स्पेक्ट्रोस्कोपी (ईआई-एमएस) और चक्रीय वोल्टामेट्री (सीवी) 
Updates	अभी तक के 
Lab Integration Kit 1.0.0 Released	प्रयोगशाला एकीकरण सामग्री 1.0.0 जारी कर दी गयी 
Summer Sprint Integration Workshop at IIT Guwahati	आईआईटी गुवाहाटी में ग्रीष्मकालीन स्प्रिंट एकीकरण कार्यशाला 
A new set of 35 Virtual Labs on Portable Media	पोर्टेबल मीडिया पर 35 वर्चुअल लैब्स का एक नया सेट 
VLEAD Blog	वी लीड का ब्लॉग 
Sakshat Portal	साक्षात पोर्टल 
Nodal Center	नोडल केंद्र 
Contact : support@vlabs.ac.in	संपर्क: support@vlabs.ac.in 
Feedback	प्रतिक्रिया 
Follow us	हमारा अनुसरण करें
