Welcome to Virtual Labs - A MHRD Govt of india Initiative	एमएचआरडी भारत सरकार का एक उपक्रम -वर्चुअल लैब्स में, आपका स्वागत है 
Toggle navigation	टॉगल से संचालित करना 
HOME	गृह 
ALL LABS	सभी प्रयोगशालाएँ 
PARTNERS	भागीदार 
CONTACT	संपर्क 
Chemical Sciences	रसायन विज्ञान 
Introduction Experiments Target Audience Courses Aligned Pre-requisite Softwares Feedback	परिचय, प्रयोग, लक्ष्य, श्रोतागण, पाठ्यक्रम, संरेखित पूर्वाकांक्षित सॉफ्टवेयर्स, प्रतिक्रिया 
Physical Chemistry Lab	भौतिकी रसायन विज्ञान प्रयोगशाला 
Instrumentation and working principles of infra red (IR) spectroscopy using salt plates.	नमक प्लेटों का उपयोग करते हुए इन्फ्रा रेड (आईआर) स्पेक्ट्रोस्कोपी के उपकरण एवं कार्य सिद्धांत। 
Instrumentation and working principles of solutions infra red (IR) spectroscopy	विलयन इन्फ्रा रेड (आईआर) स्पेक्ट्रोस्कोपी के उपकरण एवं कार्य सिद्धांत। 
Instrumentation and working principles principles of mass spectroscopy	द्रव्यमान स्पेक्ट्रोस्कोपी के उपकरण एवं कार्य सिद्धांत। 
Determination of molar mass of simple compounds using mass spectroscopy	द्रव्यमान स्पेक्ट्रोस्कोपी का उपयोग करके सरल यौगिकों के आणविक द्रव्यमान का निर्धारण 
Nuclear magnetic resosnace spectrocopy and evaulation of simple 1H NMR spectra of select organic compounds	नाभिकीय चुंबकीय अनुकम्पन स्पेक्ट्रोस्कोपी और चुने हुए सरल कार्बनिक यौगिकों के 1 एच एनएमआर स्पेक्ट्रा का मूल्यांकन 
Identification of unknown components using spectroscopic techniques.	स्पेक्ट्रोस्कोपिक तकनीकों का उपयोग करके अज्ञात घटकों की पहचान। 
Updates	सुधार किए गए 
Lab Integration Kit 1.0.0 Released	 कार्यशाला एकीकरण सामग्री 1.0.0 जारी की गयी 
Summer Sprint Integration Workshop at IIT Guwahati	आईआईटी गुवाहाटी में ग्रीष्मकालीन स्प्रिंट एकीकरण कार्यशाला 
A new set of 35 Virtual Labs on Portable Media	पोर्टेबल मीडिया पर 35 वर्चुअल लैब्स का एक नया सेट 
VLEAD Blog	वीलीड का ब्लॉग 
Sakshat Portal	साक्षात पोर्टल 
Nodal Center	नोडल केंद्र 
Contact : support@vlabs.ac.in	संपर्क: support@vlabs.ac.in 
Feedback	प्रतिक्रिया 
Follow us	हमारा अनुसरण करें