Welcome to Virtual Labs - A MHRD Govt of india Initiative	आभासी प्रयोगशालाओं (वर्चुअल लैब्ज्) में आपका स्वागत है-भारत सरकार के मानव संसाधन विकास मंत्रालय की पहल 
Toggle navigation	टॉगल नेविगेशन 
HOME	घर (होम) 
ALL LABS	सभी प्रयोगशालाएं (लैब्ज्) 
PARTNERS	भागीदार 
CONTACT	संपर्क करें 
Chemical Sciences	रसायन विज्ञान 
Introduction Experiments Target Audience Courses Aligned Pre-requisite Softwares Feedback	प्रस्तावना/भूमिका, प्रयोग, टारगेट ऑडियन्स, संरेखित पाठ्यक्रम, पूर्व-नियोजित सॉफ्टवेयर्स, प्रतिक्रिया(फिडवैक) 
Physical Chemistry Lab	भौतिक रसायन विज्ञान प्रयोगशाला 
UG	स्नातक(यूजी) 
Final year of B.Tech. Chemical/Materials/Biotechnolgy Engineering	बी.टेक अंतिम वर्ष रासायनिक / सामग्री(मटेरियल) / जैव-प्राद्यौगिकी(बायोटेक्नोलॉजी) अभियांत्रिकी/ औषध निर्माण विज्ञान
B. Pharm., Biomed. Engg.	(बी-फार्म), जैविक-चिकित्सा(बायोमेड) अभियांत्रिकी। 
PG	स्नातकोत्तर (पीजी) 
Chemistry, Chemical/Materials/Biomedical Engg., Biotech & Pharm.	रसायन विज्ञान, रसायन / सामग्री / जैव-चिकीत्सा(बायोमेडिकल) अभियांत्रिकी, जैव-प्राद्यौगिकी(बायोटेक) और औषधि-विज्ञान(फार्मा)। 
1st year of Ph.D. in Chemistry related fields	पीएचडी प्रथम वर्ष रसायन विज्ञान से संबंधित क्षेत्र 
Updates	अब तक का (अपडेट) 
Lab Integration Kit 1.0.0 Released	लैब इंटीग्रेशन किट 1.0.0 जारी किया गया 
Summer Sprint Integration Workshop at IIT Guwahati	आईआईटी गुवाहाटी में ग्रीष्मकालीन स्प्रिंट एकीकरण कार्यशाला 
A new set of 35 Virtual Labs on Portable Media	पोर्टेबल मीडिया पर 35 आभासी प्रयोगशालाओं का एक नया सेट 
VLEAD Blog	विलिड ब्लॉग 
Sakshat Portal	साक्षात पोर्टल 
Nodal Center	नोडल केंद्र 
Contact : support@vlabs.ac.in	संपर्क: support@vlabs.ac.in 
Feedback	प्रतिक्रिया 
Follow us	हमारा अनुसरण करें
