Welcome to Virtual Labs - A MHRD Govt of india Initiative	आभासी प्रयोगशालाओं (वर्चुअल लैब्स) में आपका स्वागत है- एमएचआरडी भारत सरकार की एक पहल
Toggle navigation	टॉगल से संचालित करना, टॉगल नेविगेशन(कंप्यूटर पर ढूढ़ना)
HOME	होम
ALL LABS	सभी प्रयोगशालाएँ (लैब्स)
PARTNERS	भागीदार
CONTACT	संपर्क करें
Chemical Sciences →Physical Chemistry Lab →List Of Experiments	रासायनिक विज्ञान → भौतिक रसायन विज्ञान प्रयोगशाला → प्रयोगों की सूची
Introduction Theory Objective Experiment Manual Quizzes Further Readings Feedback	भूमिका, सिद्धांत,उद्देश्य, प्रयोग, नियमावली (मैनुअल), क्विज़, आगे के पाठ्यांक, प्रतिक्रिया
Identification of Unknown Components Using Spectroscopic Techniques	स्पेक्ट्रोस्कोपिक तकनीकों का उपयोग करके अज्ञात घटकों की पहचान
Instrumentation and working principles of Infra Red (IR) Spectroscopy using salt plates.	नमक प्लेटों का उपयोग करके इन्फ्रा रेड (आईआर) स्पेक्ट्रोस्कोपी के इंस्ट्रूमेंटेशन और काम के सिद्धांत।
Determination of Molar Mass of Simple Compounds Using Mass Spectroscopy	मास स्पेक्ट्रोस्कोपी का उपयोग कर सरल यौगिकों के मोलर द्रव्यमान का निर्धारण
Nuclear magnetic resosnace spectrocopy and evaulation of simple 1H NMR spectra of select organic compounds	नाभिकीय चुंबकीय अनुनाद स्पेक्ट्रोस्कोपी और चुनिंदा कार्बनिक यौगिकों के सरल 1H एनएमआर स्पेक्ट्रा का उद्भव
Updates	अपडेट्स(अभी_तक के)
Lab Integration Kit 1.0.0 Released	लैब इंटीग्रेशन किट 1.0.0 जारी किया गया(प्रयोगशाला एकीकरण सामग्री 1.0.0 जारी की गई)
Summer Sprint Integration Workshop at IIT Guwahati	आईआईटी गुवाहाटी में ग्रीष्मकालीन स्प्रिंट एकीकरण कार्यशाला
A new set of 35 Virtual Labs on Portable Media	पोर्टेबल मीडिया पर 35 आभासी प्रयोगशालाओं (वर्चुअल लैब्स) का एक नया सेट
VLEAD Blog	वीलिड ब्लॉग
Sakshat Portal	साक्षात पोर्टल
Nodal Center	नोडल केंद्र
Contact : support@vlabs.ac.in	संपर्क: support@vlabs.ac.in
Feedback	प्रतिक्रिया
Follow us	हमारा अनुगमन करें
