Welcome to Virtual Labs - A MHRD Govt of india Initiative	భారత ప్రభుత్వం చొరవతో, MHRD-వర్చువల్ ప్రయెాగశాలకు స్వాగతం 
Toggle navigation	టోగుల్ నావిగేషన్‌ 
HOME	హోం 
ALL LABS	అన్ని ప్రయెాగశాలలు 
PARTNERS	భాగస్వాములు 
CONTACT	సంప్రదించండి 
Chemical Sciences →Physical Chemistry Lab →List Of Experiments	రసాయన శాస్త్రాలు → భౌతిక రసాయన ప్రయెాగశాల → ప్రయోగాల జాబితా 
Introduction Theory Objective Experiment Manual Quizzes Further Readings Feedback	పరిచయం సిద్ధాంతం లక్ష్యం ప్రయోగాలు సంపుటి క్విజ్స్ ముందస్తు అవసరమైన సాఫ్ట్‌వేర్లు అభిప్రాయాలు 
Instrumentation and Working Principles of Solutions Infra Red (IR) Spectroscopy	ఇన్ఫ్రా రెడ్ (ఐఆర్) స్పెక్ట్రోస్కోపీ యెుక్క నిర్మాణం మరియు పని చేసే సూత్రాలు 
Follow the procedure given below:	క్రింద ఇచ్చిన విధానాన్ని అనుసరించండి: 
(1) Click on the sample bottle to transfer small amount (2-5mg) of the substance into the empty sample bottle.	(1) పదార్థంలో చిన్న మొత్తాన్ని (2-5 ఎంజి) ఖాళీ నమూనా బాటిల్‌లోకి బదిలీ చేయడానికి నమూనా బాటిల్‌పై క్లిక్ చేయండి. 
(2) Click on the solvent bottle to transfer 2 to 3ml of the solvent (CCl4) to the sample to prepared a clear solution.	(2) స్పష్టమైన ద్రావణం సిద్ధం చేయడానికి 2 నుండి 3 మి.లీ ద్రావకంను(సిసిఎల్ 4) నమూనాకు బదిలీ చేయడానికి ద్రావకం(solvent) బాటిల్‌పై క్లిక్ చేయండి. 
(3) Click on the desiccator to take out the 'solution IR cell'.	(3) ద్రావణం ఐర్ సెల్ (solution IR cell) ను తీయడానికి 'Desiccator'(డెసికేటర్)పై క్లిక్ చేయండి. 
(4) Click on the sample solution to draw 1ml of the solution with a syringe	(4) సిరంజితో 1 మి.లీ ద్రావణాన్ని తీయడానికి నమూనా ద్రావణం(sample solution)పై క్లిక్ చేయండి 
(5) Click on the solution IR cell to transfer the sample solution until all the air is expelled from the solution cell.	(5) ద్రావణం సెల్ నుండి గాలిని బహిష్కరించే వరకు నమూనా ద్రావణాన్ని ద్రావణం సెల్ కు బదిలీ చేయడానికి 'Solution IR Cell'(ద్రావణం ఐర్ సెల్)పై క్లిక్ చేయండి. 
(6) Click on the solution IR cell to place the cell inside the spectrometer.	(6) స్పెక్ట్రోమీటర్ లోపల కణాన్ని ఉంచడానికి 'Solution IR Cell'(ద్రావణం ఐర్ సెల్) పై క్లిక్ చేయండి. 
(7) Click on 'start' button to start the spectrometer.	(7) స్పెక్ట్రోమీటర్ ప్రారంభించడానికి 'start' (ప్రారంభించు) బటన్ పై క్లిక్ చేయండి. 
(8) Click on the evaluate button to spectral analysis.	(8) స్పెక్ట్రల్ విశ్లేషణకు 'Evaluate' (మూల్యాంకనం) బటన్ పై క్లిక్ చేయండి. 
Updates	నవీకరణలు 
Lab Integration Kit 1.0.0 Released	ప్రయెాగశాల అనుసంధాన కిట్ 1.0.0 విడుదల చేయబడింది 
Summer Sprint Integration Workshop at IIT Guwahati	ఐఐటి గౌహతిలో సమ్మర్ స్ప్రింట్ ఇంటిగ్రేషన్ వర్క్‌షాప్ 
A new set of 35 Virtual Labs on Portable Media	పోర్టబుల్ మీడియాలో 35 వర్చువల్ ప్రయెాగశాలల కొత్త సమూహం 
VLEAD Blog	VLEAD బ్లాగ్ 
Sakshat Portal	సాక్షత్ పోర్టల్ 
Nodal Center	నోడల్ సెంటర్ 
Contact : support@vlabs.ac.in	సంప్రదించండి: support@vlabs.ac.in 
Feedback	అభిప్రాయం 
Follow us	మమ్మల్ని అనుసరించండి