Welcome to Virtual Labs - A MHRD Govt of india Initiative	आभासी प्रयोगशाला (वर्चुअल लैब्ज्) में आपका स्वागत-भारत सरकार के मानव संसाधन विकास मंत्रालय (एमएचआरडी) की पहल 
Toggle navigation	टॉगल नेविगेशन 
HOME	घर (होम) 
ALL LABS	सभी प्रयोगशालाएं (लैब्ज्) 
PARTNERS	भागीदार 
CONTACT	संपर्क करें 
Chemical Sciences →Physical Chemistry Lab →List Of Experiments	रासायनिक विज्ञान → भौतिक रसायन विज्ञान प्रयोगशाला → प्रयोगों की सूची 
Introduction Theory Objective Experiment Manual Quizzes Further Readings Feedback	प्रस्तावना सिद्धांत, उद्देश्य(ऑब्जेक्टिव) प्रयोग (एक्सपेरिमेंट), मैनुअल, प्रश्नावली (क्विज़), अतिरिक्त जानकारी (रीडिंग), प्रतिक्रिया (फीडबैक) 
Instrumentation and Working Principles of Solutions Infra Red (IR) Spectroscopy	इंफ्रा रेड (आईआर) स्पेक्ट्रोस्कोपी के समाधानों के यंत्रीकरण एवं कार्य सिद्धांत 
Follow the procedure given below:	नीचे दी गई प्रक्रिया का पालन करें: 
(1) Click on the sample bottle to transfer small amount (2-5mg) of the substance into the empty sample bottle.	(1) खाली बोतल में पदार्थ की छोटी मात्रा (2-5mg) को स्थानांतरित करने के लिए नमूना (सैंपल) बोतल पर क्लिक करें। 
(2) Click on the solvent bottle to transfer 2 to 3ml of the solvent (CCl4) to the sample to prepared a clear solution.	(2) साफ़ मिश्रण तैयार करने के लिए सॉल्वेंट (CCl4) के 2 से 3 मिलीलीटर द्रावक को डालने के लिए सॉल्वेंट बोतल पर क्लिक करें। 
(3) Click on the desiccator to take out the 'solution IR cell'.	(3) 'मिश्रण आईआर सेल' को बाहर निकालने के लिए डेसिकेटर पर क्लिक करें। 
(4) Click on the sample solution to draw 1ml of the solution with a syringe	(4) 1ml मिश्रण को सिरिंज से निकालने के लिए नमूना मिश्रण पर क्लिक करें 
(5) Click on the solution IR cell to transfer the sample solution until all the air is expelled from the solution cell.	(5) सैंपल सॉल्यूशन को निकालने के लिए सॉल्यूशन IR सेल पर सॉल्यूशन सेल की सारी हवा बाहर निष्कासित होते तक क्लिक करें 
(6) Click on the solution IR cell to place the cell inside the spectrometer.	(6) स्पेक्ट्रोमीटर के अंदर सेल स्थापित करने के लिए मिश्रण IR सेल पर क्लिक करें। 
(7) Click on 'start' button to start the spectrometer.	(7) स्पेक्ट्रोमीटर शुरू करने के लिए 'स्टार्ट' बटन पर क्लिक करें। 
(8) Click on the evaluate button to spectral analysis.	(8) स्पेक्ट्रल विश्लेषण के लिए मूल्यांकन बटन पर क्लिक करें। 
Updates	अब तक का(अपडेट) 
Lab Integration Kit 1.0.0 Released	लैब इंटीग्रेशन किट 1.0.0 जारी किया गया 
Summer Sprint Integration Workshop at IIT Guwahati	आईआईटी गुवाहाटी में ग्रीष्मकालीन स्प्रिंट एकीकरण कार्यशाला 
A new set of 35 Virtual Labs on Portable Media	पोर्टेबल मीडिया पर 35 आभासी प्रयोगशालाओं का एक नया सेट 
VLEAD Blog	विलीड ब्लॉग 
Sakshat Portal	साक्षात पोर्टल 
Nodal Center	नोडल केंद्र 
Contact : support@vlabs.ac.in	संपर्क: support@vlabs.ac.in 
Feedback	प्रतिक्रिया 
Follow us	हमारा अनुसरण करें