Welcome to Virtual Labs - A MHRD Govt of india Initiative	వర్చువల్ ప్రయోగశాలకు స్వాగతం-భారత ప్రభుత్వ ఎమ్ హెచ్ ఆర్ డి యొక్క చొరవ 
Toggle navigation	పేజీకి సంబంధించిన లింకులను తెరవడంను లేదా మెనూల ద్వారా తెరవడంను (నావిగేషన్‌ను)టోగుల్ చేయండి 
HOME	ముఖపుట(హోమ్) 
ALL LABS	అన్ని ప్రయోగశాలలు 
PARTNERS	భాగస్వాములు 
CONTACT	సంప్రదించండి 
Chemical Sciences	రసాయానిక విజ్ఞానశాస్త్రం 
Introduction Experiments Target Audience Courses Aligned Pre-requisite Softwares Feedback	పరిచయం, ప్రయోగాలు, ప్రేక్షకులు లక్ష్యంగా కోర్సులు, సమలేఖనం చేయబడిన ముందు-అవసరమైన సాఫ్ట్‌వేర్లు,అభిప్రాయం 
Physical Chemistry Lab	భౌతిక రసాయన శాస్త్రం ప్రయోగశాల 
Instrumentation and working principles of infra red (IR) spectroscopy using salt plates.	ఉప్పు పలకలను ఉపయోగించి ఇన్ఫ్రా రెడ్ (ఐఆర్) స్పెక్ట్రోస్కోపీ యొక్క పరికరాలు మరియు పని చేసే సూత్రాలు. 
Instrumentation and working principles of solutions infra red (IR) spectroscopy	పరిష్కారాలు ఇన్ఫ్రా రెడ్ (ఐఆర్) స్పెక్ట్రోస్కోపీ యొక్క పరికరాలు మరియు పని చేసే సూత్రాలు 
Instrumentation and working principles principles of mass spectroscopy	ద్రవ్యరాశి(మాస్) స్పెక్ట్రోస్కోపీ యొక్క పరికరాలు మరియు పని చేసే సూత్రాలు 
Determination of molar mass of simple compounds using mass spectroscopy	మాస్ స్పెక్ట్రోస్కోపీని ఉపయోగించి సాధారణ సమ్మేళనాల మోలార్ ద్రవ్యరాశిని నిర్ణయించడం 
Nuclear magnetic resosnace spectrocopy and evaulation of simple 1H NMR spectra of select organic compounds	అణు అయస్కాంత ప్రతిధ్వని(రెసోస్నేస్) స్పెక్ట్రోస్కోపీ మరియు సాధారణ 1 హెచ్ ఎన్ ఎమ్ ఆర్ వర్ణపటంలోని(స్పెక్ట్రా) కొన్ని సేంద్రియ సమ్మేళనాల మూల్యాంకనం. 
Identification of unknown components using spectroscopic techniques.	స్పెక్ట్రోస్కోపిక్ పద్ధతులను ఉపయోగించి తెలియని భాగాల గుర్తింపు. 
Updates	నవీకరణలు 
Lab Integration Kit 1.0.0 Released	ప్రయోగశాల అనుసంధాన(ఇంటిగ్రేషన్) సంభందిత సామాను(కిట్) 1.0.0 విడుదల చేయబడింది. 
Summer Sprint Integration Workshop at IIT Guwahati	ఐ ఐ టి గౌహతిలో వేసవి స్ప్రింట్ అనుసంధాన కార్యసాల(వర్కషాప్) 
A new set of 35 Virtual Labs on Portable Media	చిన్న (పోర్టబుల్) ప్రసార మాధ్యమంలో 35 వర్చువల్ ప్రయోగశాలల కొత్త సమూహం(సెట్) 
VLEAD Blog	విలీడ్ బ్లాగ్ 
Sakshat Portal	సాక్షాత్ పోర్టల్ 
Nodal Center	నోడల్ కేంద్రం(సెంటర్) 
Contact : support@vlabs.ac.in	సంప్రదించండి: support@vlabs.ac.in 
Feedback	అభిప్రాయం 
Follow us	మమ్మల్ని అనుసరించండి